**************************************
*                                    *
*                GGGGG               *
*                G    G              * 
*                                    * 
*   %%      $      %%      %%        * 
*   %%$$$%%%$$$%%%$$$$%$$$$$$$$%      * 
*                %%                 %%*
*   $$$$$$$$$$$$$$$$$$$$$$$$$$$$$$$$$$*
**************************************